....#....
...#.#...
..#.*0#..
.#.0...#.
#......@#
.#.*#..#.
..#...#..
...#.#...
....#....