########
#@###..#
#..##*.#
#......#
#.##...#
#0.##..#
########