########
#.###..#
#..##..#
#......#
#@##...#
#%.##..#
########