.########.
##.....@##
#.*.##..0#
#...#.*..#
##.0....##
.########.