.##...##.
#.##.##.#
#@.###..#
#.....*.#
##.#....#
.###.###.
..##0##..
...###...