....#....
...#.#...
..#..%#..
.#.%...#.
#..@....#
.#..#..#.
..#...#..
...#.#...
....#....