#########
#...##.0#
#.*.#.@.#
#..###..#
#..###..#
#...#...#
#..##.*.#
#0......#
#########