#########
#...##.%#
#...#...#
#..###..#
#..###..#
#...#...#
#@.##...#
#%......#
#########