..#####.
###...#.
#...#.##
#.#..%.#
#...@#.#
##.#%..#
.#...###
.#####..