..#####.
###...#.
#.*.#.##
#.#..0.#
#....#.#
##*#0..#
.#@..###
.#####..