.##...##.
#.##.##.#
#..###..#
#.......#
##.#....#
.###@###.
..##%##..
...###...